WE sprites/water.xpm
EA sprites/crystal.xpm
NO sprites/rock.xpm
SO sprites/ship_left.xpm




C 255,255,0
F 255,20,147



111111111111111111111111111111
100000000000000000000000000001
100000000000000000000000000001
100000001111000000000000000001
100000010E00100000000000000001
100000100000010000000000000001
100001000000001000000000000001
100111111111111110000000000001
100000010000100000000000000001
100000100000010000000000000001
100001000000001000000000000001
100010000000000100000000000001
100100000000000010000000000001
100000000000000000000000000001
111111111111111111111111111111