WE sprites/water.xpm
EA sprites/crystal.xpm
NO sprites/rock.xpm
SO sprites/ship_left.xpm


C 255,255,0
F 255,20,147


111111111111
100000000001
111011111101
11N000000101
110000010101
100000010101
100000010101
111111111111