



WE sprites/water.xpm
EA sprites/crystal.xpm
NO sprites/rock.xpm
SO sprites/ship_left.xpm




C 255,255,0
F 255,20,147


                                       11
                     011111           1101
011111111111       11100000111       100001
100000000001      1000000000001      10001
100000000001111111100000000000011     111
1000000000000000000000000000000001
0111111110000000100000111111111111
       111111101101111 10001
       10000000001N001 10001
       100000000000101  000
        11111111111101
                    10




