WE sprites/wallw.xpm
EA sprites/walle.xpm
NO sprites/walln.xpm
SO sprites/walls.xpm
F 20,160,220
C 255,180,35


011111110
111101111
110000001
10W000001
011111110








