1111111111111
10000000000E1
100C0000000001
1P00000000001
1111111111111