11111111
1C0000E1
10010001
10000001
100P0001
11111111

