11111111111111111111111111111111111111111111
10000000000000000000001000000000000000000001
11111111011111111111101011111111111111111101
1000000101000000000C1010000000000000000001E1
10111101010111111111101011111110111110111111
101C0P0101010000000010101C000010100C101C0001
10111111010101111110101011111010101110111101
10000000000101000000100000000010100000000001
11111111011111011110111111111110101111111111
1C00000001C000000C100000000000001000000000C1
11111111111111111111111111111111111111111111