111111111111111
1000000000000E1
100000000000001
1P0000000000001
111111111111111
