111111111111111
100000000000001
100000000000001
1P00000000000C1
111111111111111
