1111111111111
10000011PCE11
1111111111111
1111111111111