1111111111
1C000000E1
1000000001
1P00000001
1111111011