1111111111
0C000000E1
1000000001
1P00000001
1111111111